........................................
........................................
........................................
........................................
....BBBBBBBBBBBBBBBBBBBBBBBBBBBBBBBB....
....BBBBBBBBBBBBBBBBBBBBBBBBBBBBBBBB....
....BB............................BB....
....BB............................BB....
....BB..SSSSSSSSSSSSSSSSSSSSSSSS..BB....
....BB..SSSSSSSSSSSSSSSSSSSSSSSS..BB....
....BB..SS....................SS..BB....
....BB..SS....................SS..BB....
....BB..SS....................SS..BB....
....BB..SS....................SS..BB....
....BB..SS....................SS..BB....
....BB..SS....................SS..BB....
....BB..SS.........EE.........SS..BB....
....BB..SS.........EE.........SS..BB....
....BB..SS....................SS..BB....
....BB..SS....................SS..BB....
....BB..SS....................SS..BB....
....BB..SS....................SS..BB....
....BB..SS....................SS..BB....
....BB..SS....................SS..BB....
....BB..SSSSSSSSSSSSSSSSSSSSSSSS..BB....
....BB..SSSSSSSSSSSSSSSSSSSSSSSS..BB....
....BB............................BB....
....BB............................BB....
....BBBBBBBBBBBBBBBBBBBBBBBBBBBBBBBB....
....BBBBBBBBBBBBBBBBBBBBBBBBBBBBBBBB....
........................................
........................................
........................................
........................................